19 19 19 19 19 19 19 19 19 19 19 19 19 19 19 19 19 19 19 19 19 19 19 19 19 19 19 19 19 19 19 19 19 19 19 19 19 19 19 19 19 19 19 19 19 19 19 19 19 19 
19 19 19 19 19 19 19 19 19 19 19 19 19 19 19 19 19 19 19 19 19 19 19 19 19 19 19 19 19 19 19 19 19 19 19 19 19 19 19 19 19 19 19 19 19 19 19 19 19 19 
19 19 19 19 19 19 19 19 19 19 19 19 19 19 19 19 19 19 19 19 19 19 19 19 19 19 19 19 19 19 19 19 19 19 19 19 19 19 19 19 19 19 19 19 19 19 19 19 19 19 
19 19 19 19 19 19 19 19 19 19 19 0 0 0 0 0 0 0 0 0 0 0 0 0 0 0 19 19 19 19 19 19 19 19 19 19 19 19 19 19 19 19 19 19 19 19 19 19 19 19 
19 19 19 19 19 19 19 19 19 19 0 0 0 0 0 0 0 0 0 0 0 0 0 0 0 0 0 0 0 19 19 19 19 19 19 19 19 19 19 19 19 19 19 19 0 0 0 0 19 19 
19 19 19 19 19 19 19 19 19 0 0 0 0 0 0 0 0 0 0 0 0 0 0 0 0 0 0 0 0 0 0 0 0 0 0 0 0 0 0 0 0 0 0 0 0 0 0 0 19 19 
19 19 19 19 19 19 19 0 0 0 0 0 0 0 0 0 0 0 0 0 0 0 0 0 0 0 0 0 0 0 0 0 0 0 0 0 0 0 0 0 0 0 0 0 0 0 0 0 19 19 
19 19 19 19 19 19 0 0 0 0 0 0 0 0 0 0 0 0 0 0 0 0 0 0 0 0 0 0 0 0 0 0 0 0 0 0 0 0 0 0 0 0 0 0 0 0 0 0 19 19 
19 19 19 19 19 0 0 0 0 0 0 0 0 0 0 0 0 0 0 0 0 0 0 0 0 0 0 0 0 0 0 0 0 0 0 0 0 0 0 0 0 0 0 0 0 0 0 0 19 19 
19 19 19 19 0 0 0 0 0 0 0 0 0 0 0 0 0 0 0 0 0 0 0 0 0 0 0 0 0 0 0 0 0 0 0 0 0 0 0 0 0 0 0 0 0 0 0 0 19 19 
19 19 19 19 0 0 0 0 0 0 0 0 0 0 0 0 0 0 0 0 0 0 0 0 0 0 0 0 0 0 0 0 0 0 0 0 0 0 0 0 0 0 0 0 0 0 0 0 19 19 
19 19 19 0 0 0 0 0 0 0 0 0 0 0 0 0 0 0 0 0 0 0 0 0 0 0 0 0 0 0 0 0 0 0 0 0 0 0 0 0 0 0 0 0 0 0 0 19 19 19 
19 19 19 0 0 0 0 0 0 0 0 0 0 0 0 0 0 0 0 19 19 19 19 19 19 19 19 19 19 19 19 19 19 19 19 19 19 19 19 19 19 19 19 0 0 0 0 19 19 19 
19 19 19 0 0 0 0 0 0 0 0 0 0 0 0 0 0 0 19 19 19 19 19 19 19 19 19 19 19 19 19 19 19 19 19 19 19 19 19 19 19 19 19 19 0 0 0 19 19 19 
19 19 19 0 0 0 0 0 0 0 0 0 0 0 0 0 0 19 19 19 19 19 19 19 19 19 19 19 19 19 19 19 19 19 19 19 19 19 19 19 19 19 19 19 0 0 0 19 19 19 
19 19 19 19 0 0 0 0 0 0 0 0 0 0 0 0 0 19 19 19 19 3 3 3 19 19 19 19 19 19 19 19 19 19 19 19 19 19 19 19 19 19 19 19 0 0 0 19 19 19 
19 19 19 19 19 0 0 0 0 0 0 0 0 0 0 0 0 19 19 19 3 3 3 3 3 3 19 19 19 19 19 19 19 19 19 19 19 19 19 19 19 19 19 0 0 0 0 19 19 19 
19 19 19 19 19 19 0 0 0 0 0 0 0 0 0 0 0 19 19 19 3 3 3 3 3 3 3 19 19 19 19 19 19 0 0 0 0 0 0 0 0 0 0 0 0 0 0 19 19 19 
19 19 19 19 19 19 19 19 19 19 19 0 0 0 0 0 0 19 19 19 3 3 3 3 3 3 3 3 19 19 19 19 0 0 0 0 0 0 0 0 0 0 0 0 0 0 0 0 0 19 
19 19 19 19 19 19 19 19 19 19 19 0 0 0 0 0 0 19 19 19 3 3 3 3 3 3 3 3 19 19 19 0 0 0 0 0 0 0 0 0 0 0 0 0 0 0 0 0 0 19 
19 19 19 19 19 19 19 19 19 19 19 0 0 0 0 0 0 19 19 19 3 3 3 3 3 3 3 3 19 19 0 0 0 0 0 0 0 0 0 0 0 0 0 0 0 0 0 0 0 19 
19 19 19 19 19 19 19 19 19 19 19 0 0 0 0 0 0 19 19 19 3 3 3 3 3 3 3 3 19 19 0 0 0 0 0 0 0 0 0 0 0 0 0 0 0 0 0 0 19 19 
19 19 19 19 19 19 19 19 19 19 19 0 0 0 0 0 0 19 19 19 3 3 3 3 3 3 3 3 19 19 0 0 0 0 0 0 0 0 0 0 0 0 0 0 0 0 0 0 19 19 
19 19 19 19 19 19 19 19 19 19 19 19 0 0 0 0 19 19 19 19 3 3 3 3 3 3 3 3 3 19 0 0 0 0 0 19 19 19 19 19 19 19 19 19 19 19 19 19 19 19 
19 19 19 19 19 19 19 19 19 19 19 19 19 0 0 19 19 19 19 19 3 3 3 3 3 3 3 3 3 19 0 0 0 0 19 19 19 19 19 19 19 19 19 19 19 19 19 19 19 19 
19 19 19 19 19 19 19 19 19 19 19 19 19 0 0 19 19 19 19 19 3 3 3 3 3 3 3 3 3 19 0 0 0 0 19 19 19 19 19 19 19 19 19 19 19 19 19 19 19 19 
19 19 19 19 19 19 19 19 19 19 19 19 19 0 0 19 19 19 19 19 19 19 19 3 3 3 3 3 19 19 0 0 0 0 19 19 19 19 19 19 19 19 19 19 19 19 19 19 19 19 
19 19 19 19 19 19 0 0 0 0 0 0 0 0 0 0 19 19 19 19 19 19 19 19 19 19 19 19 19 19 0 0 0 0 19 19 19 19 19 19 19 19 19 19 19 19 19 19 19 19 
19 19 19 19 0 0 0 0 0 0 0 0 0 0 0 0 0 19 19 19 19 19 19 19 19 19 19 19 19 19 0 0 0 0 19 19 19 19 19 19 19 19 19 19 19 19 19 19 19 19 
19 19 19 0 0 0 0 0 0 0 0 0 0 0 0 0 0 0 0 19 19 19 19 19 19 19 19 19 19 19 0 0 0 0 19 19 19 19 19 19 19 19 19 19 19 19 19 19 19 19 
19 0 0 0 0 0 0 0 0 0 0 0 0 0 0 0 0 0 0 19 19 19 19 19 19 19 19 19 19 19 0 0 0 0 0 19 19 19 19 19 19 19 19 19 19 19 19 19 19 19 
19 0 0 0 0 0 0 0 0 0 0 0 0 0 0 0 0 0 0 19 19 19 19 19 19 19 19 19 19 19 0 0 0 0 0 0 0 0 0 0 0 0 0 0 0 0 19 19 19 19 
19 0 0 0 0 0 0 0 0 0 0 0 0 0 0 0 0 0 0 19 19 19 19 19 19 19 19 19 19 19 0 0 0 0 0 0 0 0 0 0 0 0 0 0 0 0 19 19 19 19 
19 0 0 0 0 0 0 0 0 0 0 0 0 0 0 0 0 0 0 19 19 19 19 19 19 19 19 19 19 19 0 0 0 0 0 0 0 0 0 0 0 0 0 0 0 0 19 19 19 19 
19 0 0 0 0 0 0 0 0 0 0 0 0 0 0 0 0 0 0 19 19 19 19 19 19 19 19 3 3 19 19 19 0 0 0 0 0 0 0 0 0 0 0 0 0 0 19 19 19 19 
19 0 0 0 0 0 0 0 0 0 0 0 0 0 0 0 0 0 0 19 19 19 19 19 19 3 3 3 3 3 19 19 19 19 19 19 19 19 19 19 19 19 19 19 0 0 19 19 19 19 
19 0 0 0 0 0 0 0 0 0 0 0 0 0 0 0 0 0 0 19 19 3 3 3 3 3 3 3 3 19 19 19 19 19 19 19 19 19 19 19 19 19 19 19 0 0 0 19 19 19 
19 0 0 0 0 0 0 0 0 0 0 0 0 0 0 0 0 0 0 19 19 3 3 3 3 3 3 3 3 19 19 19 19 19 19 19 19 19 19 19 19 19 19 19 0 0 0 19 19 19 
19 0 0 0 0 0 0 0 0 0 0 0 0 0 0 0 0 0 19 19 19 3 3 3 3 3 3 3 3 19 19 19 19 0 0 0 0 0 0 0 0 0 0 0 0 0 0 19 19 19 
19 0 0 0 0 0 0 0 0 0 0 0 0 0 0 0 0 19 19 19 19 19 3 3 3 3 3 3 3 19 19 19 0 0 0 0 0 0 0 0 0 0 0 0 0 0 0 19 19 19 
19 0 0 0 0 19 19 19 19 0 0 0 0 0 0 19 19 19 19 19 19 19 19 19 3 3 3 3 19 19 0 0 0 0 0 0 0 0 0 0 0 0 0 0 0 0 0 19 19 19 
19 19 0 0 19 19 19 19 19 19 19 19 19 19 19 19 19 19 19 19 19 19 19 19 19 19 19 19 19 19 0 0 0 0 0 0 0 0 0 0 0 0 0 0 0 0 0 0 19 19 
19 19 0 0 19 19 19 19 19 19 19 19 19 19 19 3 3 3 3 19 19 19 19 19 19 19 19 19 19 19 0 0 0 0 0 0 0 0 0 0 0 0 0 0 0 0 0 0 19 19 
19 19 0 0 19 19 19 19 19 19 19 19 19 19 3 3 3 3 3 3 19 19 19 19 19 19 19 19 19 19 0 0 0 0 0 0 0 0 0 0 0 0 0 0 0 0 0 0 19 19 
19 19 0 0 19 19 19 19 19 19 19 19 3 3 3 3 3 3 3 3 3 19 19 19 19 19 19 19 19 19 19 0 0 0 0 0 0 0 0 0 0 0 0 0 0 0 0 0 19 19 
19 19 0 0 19 19 19 19 19 19 19 3 3 3 3 3 3 3 3 3 3 3 19 19 19 19 19 19 19 19 19 19 0 0 0 0 0 0 0 0 0 0 0 0 0 0 0 19 19 19 
19 19 0 0 19 19 19 19 19 19 19 3 3 3 3 3 3 3 3 3 3 3 3 3 3 3 3 19 19 19 19 19 19 0 0 0 0 0 0 0 0 0 0 0 0 0 19 19 19 19 
19 19 0 0 19 19 19 19 19 19 3 3 3 3 3 3 3 3 3 3 3 3 3 3 3 3 3 3 19 19 19 19 19 19 0 0 0 0 0 0 0 0 0 0 0 19 19 19 19 19 
19 19 0 0 19 19 19 19 19 3 3 3 3 3 3 3 3 3 3 3 3 3 3 3 3 3 3 3 3 3 19 19 19 19 19 19 19 19 19 19 19 19 19 19 19 19 19 19 19 19 
19 19 0 0 19 19 19 19 19 3 3 3 3 3 3 3 3 3 3 3 3 3 3 3 3 3 3 3 3 3 3 3 19 19 19 19 19 19 19 19 19 19 19 19 19 19 19 19 19 19 
